                
                
                
NNNNNNvvNNNNTNNN
NNNNNNvvNNNNTEEN
BNNNNDvvNNNNTEEN
NNNNNNvvNNNNTNNN
ppppppvvpppppppp
SSSSSSvvSSSSSSSS
SSSSSDvvSSSCSSSS
ASSSSSvvSSSSSSSS
SSSSSSvvSSSSSSSS